{"dimX":25,"dimY":18,"title":"Joint Forces",
"author":"sekti",
"finished":false,"startX":2,"startY":3,"map":[
"                         ",
"                         ",
"   ··                    ",
"  R····   ···            ",
"  ······ ·····   ····    ",
"  b····· R·1··· R·····   ",
"  ··1··· ······ ···1··   ",
"   ·····  ··b·   ····    ",
"    ·b         B         ",
"                         ",
"                         ",
"           ·             ",
"          ···            ",
"         ··S··           ",
"          ···            ",
"           ·             ",
"                         ",
"                         "]
}