{"dimX":30,"dimY":30,"title":"No one left behind",
"author":"sekti",
"finished":false,"startX":9,"startY":7,"map":[
"                              ",
"                              ",
"                              ",
"                              ",
"                              ",
"                ···           ",
"          ··b  B·R··          ",
"         R2···  ···b          ",
"         ····b ······         ",
"         ····  1·2···         ",
"         ·1··  ·····          ",
"            b  ·b··           ",
"               ···            ",
"               ··             ",
"                              ",
"                              ",
"                              ",
"               ··             ",
"               ···            ",
"              ····            ",
"              ··b·            ",
"              ··              ",
"                              ",
"                              ",
"               ···            ",
"               ·S·            ",
"               ···            ",
"                              ",
"                              ",
"                              "]
}