{"dimX":36,"dimY":42,"title":"You're surrounded",
"author":"sekti",
"finished":false,"startX":19,"startY":10,"map":[
"                                    ",
"                                    ",
"                                    ",
"                                    ",
"                                    ",
"                                    ",
"                                    ",
"                                    ",
"                                    ",
"                   ·····            ",
"                  ·R2···            ",
"         B        b·····            ",
"        B          ··2              ",
"                  ···  ···          ",
"                      ·R1·          ",
"              ···     b·1·          ",
"              ·S·  B   ···          ",
"              ···      ···          ",
"                                    ",
"                                    ",
"                      R·            ",
"                      ·b·           ",
"                      2··           ",
"                   b·····           ",
"                   ·····2           ",
"                   ··1··            ",
"                    ··              ",
"                        R·          ",
"                        ·1          ",
"                        ·1B         ",
"        B                 b         ",
"         B                          ",
"                                    ",
"                                    ",
"                                    ",
"                                    ",
"                                    ",
"                                    ",
"                                    ",
"                                    ",
"                                    ",
"                                    "]
}